111112111111111111111111
100000000000000000000001
100110000000000000001001
100000000000000000001001
100000000000000000001001
100000000000000000001001
100000001110000000000001
100000000100000000000001
1000000000000000000Z0001
100000000000000000000001
100000000000000000000001
100000000000000000000001
100000000000000000000001
100000000000000000000001
100000000000000000000002
200000000000000000000001
100000000000000000000001
100000000000000000000001
100000000000000000000001
100000000000000000000001
100000000000000000000001
100000000000000000000001
100000000000000000000001
100011001111111111001111
100010001111111111000001
100011001111111110000001
111111001111111110000001
122211001111111111111111
122222001111110000000011
122222000000000000000011
122211001111110000000011
111111221111111111111111
