111110111111111111111111
100000000000000000000Z01
100110000Z00000000001001
100000000000000000001001
100000000000000000001001
10000Z000000000000001001
100000001110000000000001
100000000100000000000001
1000000000000000000Z0001
100000000000000000000001
100Z00000000000000000001
100000000000000000000001
100000000000000000000001
1000ZZ000000000000000001
100000000000000000000000
000000000000000000000001
10000000000000000000Z001
100000000000000000000001
100000000000000000000001
10000Z000000000000000001
100000000000000000000001
1000000000000000000ZZ001
100000000000000000000001
10Z011001111111111001111
10001000         10000Z1
10001 00         00ZZ001
11111 00         00Z0Z01
      001111111111111111
      0Z1111111111111111
      001111111111111111
      001111111111111111
      001111111111111111
