111110111111111111111111
100000000000000000000001
100110000000000000001001
100000000000000000001001
100000000000000000001001
100000000000000000001001
100000001110000000000001
100000000100000000000001
100000000000000000000001
100000000000000000000001
100000000000000000000001
100000000000000000000001
100000000000000000000001
100000000000000000000001
100000000000000000000000
000000000000000000000001
100000000000000000000001
100000000000000000000001
100000000000000000000001
100000000000000000000001
100000000000000000000001
100000000000000000000001
100000000000000000000001
100011001111111111001111
10001000         1000001
10001 00         0000001
11111 00         0000001
      001111111111111111
      001111111111111111
      001111111111111111
      001111111111111111
      001111111111111111
